5.ox
..........
o.o...o.o.
..........
.....o....
..ooo.o.o.
